1111111111111111111111111111111111111111
1E00000000000000C00000C00000000000100C11
10100101001000000101001000000010100011C1
1010010010100101000100100000001010101101
1C0000000C00C00000000E000C0000000C100001
101001010010000010100100C0000010100011C1
10100101001000001010010000000010100011C1
10100101001000001010010000C00010100011C1
10100101000100000101001000000001010001C1
10100101000100000101001000000010100011C1
10100101000100000101001000000010100011C1
11111111CC101111110111111111111110111111
1010010100001000000101001000000010100011
1010010100001000001010010000000101000111
101001010C00000P01000010100100C000001011
1010010100000C00010000010100100000001011
101001010E000000001000001010010000000101
1010010100000000000010000010100100000001
1010010100000000000100000101001000000011
1010010100C100000010100100000C0010100011
1111111111111111111111111111111111111111