11111
1E001
10001
10C01
10001
11111